F 255            ,165                    ,                          0
C 0                   ,               0                     ,       0
NO       ./textures/bluestone.xpm          
SO      ./textures/eagle.xpm
WE                   ./textures/colorstone.xpm                         
EA  ./textures/wood.xpm




1111111111111111111111111111
1111111000000S00000001111111
1110000000000000000000000111
1100000000000000000000000011
1000000101000000010100000001
1000000000000000000000000001
1000000101000000010100000001
1000000000001010000000000001
1000000000010001000000000001
1000000000000000000000000001
1000000000010001000000000001
1000000000001010000000000001
1000000101000000010100000001
1000000000000000000000000001
1000000101000000010100000001
1100000000000000000000000011
1110000000000000000000000111
1111111000000000000001111111
1111111111111111111111111111